XXXXXXXXXXXXXXXXXXXXXXXXX
XXXXXXXXXXW0000XXXXXXXXXX
XXXXXXXXXX0XXX0XXXXXXXXXX
XXXXXXXXXX0XXX0XXXXXXXXXX
XXXXXXXXXXKXXX0XXXXXXXXXX
XXXXXXXXXX0XXX0XXXXXXXXXX
XXXXXXXXXX0XXX0XXXXXXXXXX
XXXXXXXXXXDXXX0XXXXXXXXXX
XXXXXXXXXX0XXX0XXXXXXXXXX
XXXXXXXXXX0XXX0XXXXXXXXXX
XX000000000XXX000000000XX
XX0XXXXXXXXXXXXXXXXXXX0XX
XX0XXXXXXXXXXXXXXXXXXX0XX
XX0XXXXXXXXXXXXXXXXXXX0XX
XX0XXXXXXXXXXXXXXXXXXX0XX
XX0XXXX1XXXXXXXXX2XXXX0XX
XX0XXXX0XXXXXXXXX0XXXX0XX
XX0XXXX0XXXXXXXXX0XXXX0XX
XX000000XXXXXXXXX000000XX
XXXXXXXXXXXXXXXXXXXXXXXXX


