XXXXXXXXXXXXXXXXXXXXXXXXX
XXXXXXXXX000000XXXXXXXXXX
XXXXXXXXX0XXXX0XXXXXXXXXX
XXXXXXXXX0XXXX0XXXXXXXXXX
XXXXXXXXX0XXXX0XXXXXXXXXX
XXXXXXXXX0XXXX0XXXXXXXXXX
XXXXXXXXX0XXXX0XXXXXXXXXX
XXXXX000000000000000XXXXX
XXXXX0XXX0XXXX0XXX00XXXXX
XX0XX0XXX0XXXX0XXXX0XXXXX
XX000000000000000000XXXXX
XX0XX0XXX0XXXX0XXX00XXXXX
XX0XX0XXX0XXXX0XXX00XXXXX
XX0XX0XXX0XXXX0XXX00XXXXX
XX0XX0XXX0XXXX0XXXXXXXXXX
XX00000000XXXX0XXXXXXXXXX
XXXXX0XXXXX0XX0XXXXXXXXXX
XXXXX0XXXXX0002XXXXXXXXXX
XXXXX1XXXXX0XXXXXXXXXXXXX
XXXXXXXXXXXXXXXXXXXXXXXXX


